--X-----X-B-B--o-X-------------B?--o----------oX--------oo-----M-B-B--oo--B-----------------X---B-------E------XB---X------MB-XM-oM--B----?--o----M-------?B----o-o-M----Bo---------X--X------B?------XE
-------------o-----M-XX-XM?------E-BB--o----------M---X------------?o-oB-M-------------MX----B----X-X--oB--X-X------?-----?---B----oX-o--Bo----Xo---M--B--------o----X--------------o---o--oo----XB----X
--o-X----?o---o--------M------M--X-o----oo-----------oBo------------------o-X-------X---Bo---M-----M-----o-----------B----o-----o--------------------B-----------o----XB--M--M--o---o---X---X-----M----M
-----X---------B--?---------------?--o------M-------------o-----------------XB----o-----Xo--X-oX-M------------?---------o-oX-----M-M--X----o--X-------M---B--oXB---Bo-------?--X-oo?X------------------T
------B----o-----------o-----M----oB-------XoX------------o--?M-----M-----X-M-----Xo------?----------o-M-B----o-?--B-------Xo----------o---M--B?-------------X---o?----------o---------------B---Bo----?
--o?-------B----?------------------X------------B--oX-X-o--------o-X-----?----------------------------B----M--oX----------------------ooooE--------XXBEB-B-----o-----------o-M--X-M--------------------E
-oX-----o--------------------o------oB-o------------?---MB-----------B----------o----------o-M---?--oX--?--o---o------B------o----X-o-?--oB-----oX----BXo--o-----------?------oo----------o------------M
----XB------M-XX-X-Xo--------B-o------------oX-X--o-----------?-?---M--?---XX---B-o----------oX------------o-X---o-------o--B-------------o-M--------o--?---M--oXB-B-----XX----o----o------X-----o-----v
----------M----B?----------B------------------------------------------------o-----------B----------ooo-B--X-B-----M--Bo---------BX--X--M---Bo----o--oB--o----o-o---B------M--------------------B-B-----M
------o--------------X---o-o---M----------------o-oo--o--B--------E-o----------o-------X-------o----B--M--------o-------o--------X--XXB--o------?--X?oM---X?---B-------------------------?---o----------
-------o-----X---Moo-B--B----------B-----B-------o------o-B---XB--B------M-?---B-X-------------X--o--B---M----------M------oB---o---------------------o-M---X--X-----oB----o-----?----X----------------|
---B------X---M---?Bo--------o-o-o---X-----o?-X--B--------------o---------M---M----------B---oX-M-X?oB--------Bo----o-X----B-o--oooX----------BX---Eo-----------X-B---------o-------------B-o?---------M
-----?M----------------------X--B------B--------o---X--o-M----------o-o----------o--o-------?----------B-------o-----B?------o--B------------o--M-?Bo--------XX---M-B------------------------------X---X
--o-E-------o---------X----o------------------------------o--T-oo-----T-----o----o--o----o------------------------------------------T-o---------o--o-o---------------To----------------B----T---------T-
moo-BEE-o-X------o----X-BX----B-------------o----X-----------|--XX--o-|-----o---B-B-----B--------X----B--o--B-o--o----E------BX--X-o|------B---Bo----------oX--------|-X---------------BX---|---------|-
XXX--XXXXX-X-XXXXXXXXX-XXXXXXXXXXXXXXXXX-X-XXXXXXXX-X-XXXX-XXXXX-XXXXXXXX-XXXXXXXXXXX-XXXXX-XXXXX-XXXXXX-XXXXX--XXX--XXX-XXXX-XXXXXXXX--XXXXXX-XXXXXXXXXXXXXXXXXXXXXXXXX-X-XXXXXXX--XXXX--XXXXX--X----XX
