-----o-o----o-X------X-o-o--X--o--BE----------X---------?------B-X-X---X------X-?XX?----X-M-----X-----M-X-----B-----?--------X--X-----X--Bo----X-o--B---X-X------?---------o--M-----?o-X--o-o?--XB--o--|
--o----------B---------o---o----o--BB----Bo-----------?--o------X---oB----XX----oX----B-X---oX-------B-----B--X-o-----B-------?------o--X----------X------?--BX----BX-o---B-----------Xo--B-----X--B---|
-----o--B--B---M---?---X--X---X---X--B------?----------------X-X------o--MX-----o----X-BX---BX-----X---B-B---XB--?B--------?---M----o-o----X--o---B--B-------B----o--X--B-------o----B-XX---M-o--o--B--M
--B----XB-----o-XX-----B------B-----BBB-XX---B----X-oX--X--MBB-----?----?-----B----------------X----o--BX---X-o-------oX-----BE-B----B-X----B--B-----EB--o-B----------M---B--o---XX---------------B----|
-?-o---o-Xo---X----------o-----------B---X----oo----oMB-----o--------o-o---o--X-X------B--oX--o--M-Xo-BX-B----BoB-------Xo----B--------X---oX------o-B------BBB---o--o-B---------oX-oB------------X--X-M
--------B---X--XXB?-----X----X--X-BB----o-o-------X-o-?---------oo---X-----BB-----X-?------X-----------------X--o-X---ooB--XX------------X-B-X-X---MB---?---XB---Mo----?----oXB----E---o--o--B---------o
------o-----?---------B--B---------------Xo--oXB---oo----o----oBo------B---XoBXo--B--MX-------X-B-----------?-X----o-----------B-----M---------------oo--XX-----------X--?-----oX-XB-B-M--X-XX----X----M
-X----o-------o--o------------M---o--XB--------M--------BX-X-------Bo-----o---B----X--?Xo---Xo---BB---oX---------o---------B----Bo----X------------oB----M--------o------------oB---o-B----Mo----X-X---v
----X---XBoX-X-----o----Mo-o?---o---?-X--BB---B---BB-B---Xo-B----X-X---------------X-o--o------?-Xo-B---X------Xo----o---o-----X-oB-B--BBBX------X----B---BoB-o--X--X-B-o------?---------o--------X?B--E
-----E----BXM-B-BB-Xoo------------B----X----X-----X-XM---------X-X---?MX--------B---?B-------oB-X---?---o-----X-?-B------B-----o-XX-B---X-BXBX-B----o--B--?X---M----B-X---XB--o-----------Xo-----oo-o--M
-?--B?---X---X--------oX--B----------o-X-----o---o---oBM-B-----o-B-----X--X-X--oE----B--X---X-o-------M-B----X---o-------B-?---XX-----------X--X--B-o-------oX--X---ooX--?-X--------------?--Bo-BB---o-X
-------BX---o------oB-----XX---o---o---oX?-----oo---o---o--M-?---MB---------X---B--B--B--X-------BX-o------?---o----------X--Bo----M-X--M----B-XB-oX?o?--B---BB--B----------B----oo-----o---X--o---B-o-T
--?X----------X--------?---ooB-o---o--------------BB----B---B-XM------------B----------o-B----?o-------MX-B-B-B----BB---o---X-o--o----------o-----------X??o-----------B--o----X--XB---B------o----BB--M
--o-oB--ooE-o-XT-B-Xo------X---------------X--------o-B-o-------X--BX-X-----------Bo----------------X---X----o--------B-BB--o--B-Xo---B-----Xo-B-X-----X------X-o-oX-------o-----oX--------Xo-XX------T-
mE---o---BB--oX|--X--X-----oXo----X-----------oE----XB--o-----X-----X---E-o----------X------oXo--EXo-EB-XXB------XB---B-E---X---XE----XB-------BB--o-------------oo---------oB--B--E-------XE-B-E-XE--|-
XXXXX-XXXX--XXXXXX-XXXX-XXXX-X-XXXXXXXXX-X-X-XXX-XXXXXXXXX-XXXXXXXXX-XXXX-XXXXXXX-X-X-XXX-XXXXXXXXXX-XXXXXXXXXX-XXXX-X-XXX-XXX-XXXXXXXX-XXXXXX-XXXXXXXXXXXXXXXXX---XXXXX-X-X-XXXXXXXXX-XXX-XXXXXXX-XXXXX
