-----------------------------------------------------------------?----------------------------------------------------------XX--------------------------------------BBB---------------------------------
------X------------------------------o-----------------------------o-------------BB---------------------------------------------------------------------------------------------------------------------
----o----------------------------------------------------------------------------------------------o-------------------X--------------------------------------------------------------------------------
------------XX------------------------------------------------------------o-?-----------------------X--------------M-------------------------------XXXX-------------------------------------------------
-----------------------------------------------------------------------------o-------M------------------------------------------------------------------------------------------------------------------
-------M------------------------------------------------------------------------------------------------------------------------------------------------------------------------------------------------
------------------------------------------------------------------------------X-------------------------?-------------------------------------------------T----------------------------o--------M-------
------------------------------------X----------------------------------------XTXX-T-oXXXX-------o------o--------------?----?-------X--X------X------------|----------------?---------------------------v
----M-B------X---------------------XX---------------------------?-----------XX|---|----X-------------------------o-----------------XXXX------XX---?????---|-X----o----------------T--------------------f
------------XX--------------------XXX--------------------------------------XXX|---|------------------------------------------------XXXX------XXX------B---|XXX----------?------B--|----T----T----------f
-----------XXX-------------------XXXX-------------------------------------XXXX|---|------------------------------------------------XXXX----T-XXXX--------T|XXXX-------X-----------|----|----|----------f
----------XXXX----------M-------XXXXXM-----------------------------------XXXXX|---|------------o----------------------------------XXXXXX---|-XXXXX-------||XXXXX------XX----------|----|----|----------f
---------XXXXX-----------------XXXXXX-----------------------------T-----XXXXXX|---|------------------------T----------o---X------XXXXXXXX--|-XXXXXX-----X||XXXXXX-----XXXT--------|----|----|----------f
--------XXXXXX-T--------------XXXXXXX--------X--------------------|M---XXXXXXX|---|-------------T----------|o---B--------MXX----XXXXXXXXXXT|-XXXXXXX---XX||XXXXXXX----XXX|--------|----|----|----X-----f
m------XXXXXXX-|-------------XXXXXXXX--------XX------------------M|?E-XXXXXXXX|---|-------E-----|---------E|-----X---E--?-XXXE-XXXXXXXXXXX||-XXXXXXXX-XXX||XXXXXXXX---XXX|X---EE-X|----|----|-BB-o-----X
XXXXXXXXXXXXXX-|---XXoXXXX--XXXXXXXXX---XX---XXX-XXXXXXXXX---XXXXX|XXXXXXXXXXX|---|XXXX---------|---XXXXXXX|XXXXXXXXXXXXXXXXXXXXXXXXXXXXXX||XXXXXXXXXXXXX||XXXXXXXXXXXXXX|XXXXXXXX|XX--|---X|XXXXXXXXXXX
